Second Test - bg
SumToZero
(0, 0)
4
{5, 6, 7, 8, 9}
{10, 11, 12, 13, 14}
{15, 16, 17, 18, 19}
{20, 21, 22, 23}
5 5

(0001, 0, 0, 0, 0, 0) (0001, 1, 0, 0, 0, 0) (0001, 1, 0, 0, 0, 0) (0001, 1, 0, 0, 0, 0) (1001, 1, 0, 1, 2, 0)
(1001, 0, 0, 1, 2, 1) (0001, 0, 0, 0, 0, 0) (0001, 0, 0, 0, 0, 0) (0001, 0, 0, 0, 0, 0) (0001, 0, 0, 0, 0, 0)
(0001, 0, 0, 0, 0, 0) (0001, 0, 0, 0, 0, 0) (0001, 0, 0, 0, 0, 0) (0001, 0, 0, 0, 0, 0) (1001, 0, 0, 1, 2, 2)
(1001, 0, 0, 1, 2, 5) (0001, 0, 0, 0, 0, 0) (0001, 0, 0, 0, 0, 0) (0001, 0, 0, 0, 0, 0) (0001, 1, 0, 0, 0, 0)
(0001, 0, 0, 0, 0, 0) (0001, 0, 0, 0, 0, 0) (0001, 0, 0, 0, 0, 0) (0001, 0, 0, 0, 0, 0) (0001, 1, 0, 0, 0, 0)