Second Test
SumToZero
4
{5, 6, 7, 8, 9}
{10, 11, 12, 13, 14}
{15, 16, 17, 18, 19}
{20, 21, 22, 23}
5 5

(00001, 0, 0, 0, 0, 0) (00001, 1, 0, 0, 0, 0) (00001, 1, 0, 0, 0, 0) (00001, 1, 0, 0, 0, 0) (10001, 1, 0, 1, 2, 0)
(10001, 0, 0, 1, 2, 1) (00001, 0, 0, 0, 0, 0) (00001, 0, 0, 0, 0, 0) (00001, 0, 0, 0, 0, 0) (00001, 0, 0, 0, 0, 0)
(00001, 0, 0, 0, 0, 0) (00001, 0, 0, 0, 0, 0) (00001, 0, 0, 0, 0, 0) (00001, 0, 0, 0, 0, 0) (10001, 0, 0, 1, 2, 2)
(10001, 0, 0, 1, 2, 3) (00001, 0, 0, 0, 0, 0) (00001, 0, 0, 0, 0, 0) (00001, 0, 0, 0, 0, 0) (00001, 0, 0, 0, 0, 0)
(00001, 0, 0, 0, 0, 0) (00001, 0, 0, 0, 0, 0) (00001, 0, 0, 0, 0, 0) (00001, 0, 0, 0, 0, 0) (00001, 1, 0, 0, 0, 0)